20
20
####################
#..................#
#################..#
#.#.#...#.#.....#..#
#.#.###.#.#.....#..#
#.........#........#
#.#######@#######..#
#.#.............#..#
#.#.###.#.#.###.#..#
#.#.#...#.#...#.#..#
#.######## ####.#..#
#..........#.......#
#.########..##.#####
#.........#..#.....#
#.#######.##..####.#
#.##.##...###..###.#
#.##....#....#..##.#
#.#############..#.#
#..............#...#
####################