9
9
#########
#.......#
#######.#
#.#.#...#
#.#.###.#
#.......#
#.#######
#.......#
#########