19
13
###################
#.................#
#################.#
#.#.#...#.#.....#.#
#.#.###.#.#.....#.#
#.........#.......#
#.####### #######.#
#.#.............#.#
#.#.###.#.#.###.#.#
#.#.#...#.#...#.#.#
#.#############.#.#
#.................#
###################