19
13
###################
#.................#
#################.#
#...............#.#
#.###############.#
#.......#.........#
#.#######@#######.#
#.#.#...###.....#.#
#.#...#...#.###.#.#
#.#######.#...#.#.#
#.#.....#.###.#.#.#
#...###.......#...#
###################