20
20
####################
#..................#
#################..#
#.#.#...#.#.....#..#
#.#.###.#.#.....#..#
#.........#........#
#.####### #######..#
#.#.............#..#
#.#.###.#.#.###.#..#
#.#.#...#.#...#.#..#
#.#############.#..#
#..................#
#..................#
#..................#
#..................#
#..................#
#..................#
#..................#
#..................#
####################